P#########
---#---Q-#
-#---###-#
---#-###-#
##Q#-###-#
#----#B#-#
#-#-##-#Q#
#-#--Q---#
#---#-#--#
########D#
