P#########
-#-#---Q-#
-#---Q---#
---#-###-#
#-Q--###-#
#-##-#B#-#
#-##-###-#
#-#Q-Q---#
#---#-#--#
########D#
