P#########
---#---Q-#
-#-------#
---#-###-#
##Q#-###-#
#----#B#-#
#-####-#-#
#-#--Q---#
#---#-#--#
########D#
