P--------#
-#####-#--
-#####-#--
-#---Q--#-
-#-##-#---
-#---B--#Q
-#-#---#--
-#######-#
-#########
---------D