P--------#
-#####-#--
-#####-#--
-#---Q--#-
-#-##-#---
-#---B--#Q
Q#-#--Q#--
Q###-###-#
-###-#####
Q--------D